{
  "id": "dungeon1",
  "name": "던전01",
  "tileSize": 32,
  "n": 14,
  "legend": {
    "0": {
      "name": "floor",
      "color": "#141a2b",
      "passable": true
    },
    "1": {
      "name": "wall",
      "color": "#283046",
      "passable": false
    }
  },
  "assets": {
    "bg": "assets/maps/town.png",
    "grid": "0x00FFFF"
  },
  "boss": [
    {
      "id": "chaser",
      "spawn": {
        "x": 7,
        "y": 7
      },
      "hp": 450,
      "type": "main"
    }
  ],
  "tiles": [
    [1, 1, 1, 1, 1, 1, 1, 1, 1, 1, 1, 1, 1, 1],
    [1, 1, 0, 0, 0, 0, 0, 0, 0, 0, 0, 0, 1, 1],
    [1, 0, 0, 0, 0, 0, 0, 0, 0, 0, 0, 0, 0, 1],
    [1, 0, 0, 0, 1, 0, 0, 0, 0, 1, 0, 0, 0, 1],
    [1, 0, 0, 0, 1, 1, 0, 0, 1, 1, 0, 0, 0, 1],
    [1, 0, 0, 0, 1, 0, 0, 0, 0, 1, 0, 0, 0, 1],
    [1, 0, 0, 0, 0, 0, 0, 0, 0, 0, 0, 0, 0, 1],
    [1, 0, 0, 0, 0, 0, 0, 0, 0, 0, 0, 0, 0, 1],
    [1, 0, 0, 0, 1, 0, 0, 0, 0, 1, 0, 0, 0, 1],
    [1, 0, 0, 0, 1, 1, 0, 0, 1, 1, 0, 0, 0, 1],
    [1, 0, 0, 0, 1, 0, 0, 0, 0, 1, 0, 0, 0, 1],
    [1, 0, 0, 0, 0, 0, 0, 0, 0, 0, 0, 0, 0, 1],
    [1, 1, 0, 0, 0, 0, 0, 0, 0, 0, 0, 0, 1, 1],
    [1, 1, 1, 1, 1, 1, 1, 1, 1, 1, 1, 1, 1, 1]
  ]
}
